{
  "id": 3,
  "name": "第三关 - 挑战",
  "initialMoney": 300,
  "initialHealth": 8,
  "layout": [
    [0, 0, 0, 0, 0, 0, 0, 0, 0, 0],
    [0, 2, 2, 2, 2, 2, 2, 2, 2, 0],
    [0, 2, 0, 0, 0, 0, 0, 0, 2, 0],
    [0, 3, 1, 1, 1, 1, 1, 1, 2, 0],
    [0, 2, 0, 0, 0, 0, 0, 0, 2, 0],
    [0, 2, 0, 0, 0, 0, 0, 0, 2, 0],
    [0, 2, 1, 1, 1, 1, 1, 1, 2, 0],
    [0, 2, 0, 0, 0, 0, 0, 0, 2, 0],
    [0, 2, 0, 0, 0, 0, 0, 0, 2, 0],
    [0, 2, 0, 0, 0, 0, 0, 0, 2, 0],
    [0, 2, 1, 1, 1, 1, 1, 1, 2, 0],
    [0, 2, 0, 0, 0, 0, 0, 0, 2, 0],
    [0, 2, 0, 0, 0, 0, 0, 0, 2, 0],
    [0, 2, 1, 1, 1, 1, 1, 1, 4, 0],
    [0, 2, 2, 2, 2, 2, 2, 2, 2, 0],
    [0, 0, 0, 0, 0, 0, 0, 0, 0, 0],
    [0, 0, 0, 0, 0, 0, 0, 0, 0, 0],
    [0, 0, 0, 0, 0, 0, 0, 0, 0, 0]
  ]
}
