{
  "id": 1,
  "name": "第一关 - 新手训练",
  "initialMoney": 200,
  "initialHealth": 10,
  "layout": [
    [0, 0, 0, 0, 0, 0, 0, 0, 0, 0],
    [0, 2, 2, 2, 2, 2, 2, 2, 2, 0],
    [0, 2, 0, 0, 0, 0, 0, 0, 2, 0],
    [0, 2, 0, 0, 0, 0, 0, 0, 2, 0],
    [0, 2, 0, 0, 0, 0, 0, 0, 2, 0],
    [0, 3, 1, 1, 1, 1, 1, 1, 2, 0],
    [0, 2, 0, 0, 0, 0, 0, 0, 2, 0],
    [0, 2, 0, 0, 0, 0, 0, 0, 2, 0],
    [0, 2, 0, 0, 0, 0, 0, 0, 2, 0],
    [0, 2, 0, 0, 0, 0, 0, 0, 2, 0],
    [0, 2, 1, 1, 1, 1, 1, 1, 4, 0],
    [0, 2, 0, 0, 0, 0, 0, 0, 2, 0],
    [0, 2, 0, 0, 0, 0, 0, 0, 2, 0],
    [0, 2, 0, 0, 0, 0, 0, 0, 2, 0],
    [0, 2, 2, 2, 2, 2, 2, 2, 2, 0],
    [0, 0, 0, 0, 0, 0, 0, 0, 0, 0],
    [0, 0, 0, 0, 0, 0, 0, 0, 0, 0],
    [0, 0, 0, 0, 0, 0, 0, 0, 0, 0]
  ]
}
